IFELSE="ifelse"
IF="if"
DEF="def"
LOOP="loop"
REPEAT="repeat"
START="start"
EXEC="exec"
QUIT="quit"
FOR="for"
FORALL="forall"
STOP="stop"
STOPPED="stopped"
POP="pop"
EXCH="exch"
DUP="dup"
COPY="copy"
INDEX="index"
ROLL="roll"
CLEAR="clear"
COUNT="count"
MARK="mark"
CLEARTOMARK="cleartomark"
COUNTTOMARK="counttomark"
ADD="add"
DIV="div"
IDIV="idiv"
MOD="mod"
MUL="mul"
SUB="sub"
ABS="abs"
NEG="neg"
CEILING="ceiling"
FLOOR="floor"
ROUND="round"
TRUNCATE="truncate"
SQRT="sqrt"
ATAN="atan"
COS="cos"
SIN="sin"
EXP="exp"
LN="ln"
LOG="log"
RAND="rand"
SRAND="srand"
RRAND="rrand"
ARRAY="array"
LENGTH="length"
GET="get"
PUT="put"
GETINTERVAL="getinterval"
PUTINTERVAL="putinterval"
ALOAD="aload"
ASTORE="astore"
DICT="dict"
MAXLENGTH="maxlength"
BEGIN="begin"
END="end"
LOAD="load"
STORE="store"
KNOWN="known"
ERRORDICT="errordict"
SYSTEMDICT="systemdict"
USERDICT="userdict"
CURRENTDICT="currentdict"
COUNTDICTSTACK="countdictstack"
DICTSTACK="dictstack"
STRING="string"
ANCHORSEARCH="anchorsearch"
SEARCH="search"
TOKEN="token"
EQ="eq"
NE="ne"
GE="ge"
GT="gt"
LE="le"
LT="lt"
AND="and"
NOT="not"
OR="or"
XOR="xor"
TRUE="true"
FALSE="false"
BITSHIFT="bitshift"
EXIT="exit"
COUNTEXECSTACK="countexecstack"
EXECSTACK="execstack"
TYPE="type"
CVLIT="cvlit"
CVX="cvx"
XCHECK="xckeck"
EXECUTEONLY="executeonly"
NOACCESS="noaccess"
READONLY="readonly"
RCHECK="rcheck"
WCKECK="wckeck"
CVI="cvi"
CVN="cvn"
CVR="cvr"
CVRS="cvrs"
CVS="cvs"
FILE="file"
CLOSEFILE="closefile"
READ="read"
WRITE="write"
READHEXSTRING="readhexstring"
WRITEHEXSTRING="writehexstring"
READSTRING="readstring"
WRITESTRING="writestring"
READLINE="readline"
BYTESAVAILABLE="bytesavailable"
FLUSH="flush"
FLUSHFILE="flushfile"
RESETFILE="resetfile"
STATUS="status"
RUN="run"
CURRENTFILE="currentfile"
PRINT="print"
POP_OBJECT="="
POP_OBJECT_PROCEDURE="=="
STACK="stack"
PSTACK="pstack"
PROMPT="prompt"
ECHO="echo"
SAVE="save"
RESTORE="restore"
VMSTATUS="vmstatus"
BIND="bind"
USERTIME="usertime"
VERSION="version"
GSAVE="gsave"
GRESTORE="grestore"
GRESTOREALL="grestoreall"
INITGRAPHICS="initgraphics"
SETLINEWIDTH="setlinewidth"
CURRENTLINEWIDTH="currentlinewidth"
SETLINECAP="setlinecap"
CURRENTLINECAP="currentlinecap"
SETLINEJOIN="setlinejoin"
CURRENTLINEJOIN="currentlinejoin"
SETMITERLIMIT="setmiterlimit"
CURRENTMITERLIMIT="currentmiterlimit"
SETDASH="setdash"
CURRENTDASH="currentdash"
SETFLAT="setflat"
CURRENTFLAT="currentflat"
SETGRAY="setgray"
SETHSBCOLOR="sethsbcolor"
CURRENTHSBCOLOR="currenthsbcolor"
SETRGBCOLOR="setrgbcolor"
CURRENTRGBCOLOR="currentrgbcolor"
SETSCREEN="setscreen"
CURRENTSCREEN="currentscreen"
SETTRANSFER="settransfer"
CURRENTTRANSFER="currenttransfer"
MATRIX="matrix"
CURRENTMATRIX="currentmatrix"
WCHECK="wcheck"
CVL="cvl"
CXV="cxv"
CVLLT="cvllt"
CURRENTGRAY="currentgray"
INITMATRIX="initmatrix"
IDENTMATRIX="identmatrix"
DEFAULTMATRIX="defaultmatrix"
SETMATRIX="setmatrix"
TRANSLATE="translate"
SCALE="scale"
ROTATE="rotate"
CONCAT="concat"
CONCATMATRIX="concatmatrix"
TRANSFORM="transofrm"
DTRANSFORM="dtransform"
ITRANSFORM="itransofrm"
IDTRANSFORM="idtransform"
INVERTMATRIX="invertmatrix"
NEWPATH="newpath"
CURRENTPOINT="currentpoint"
MOVETO="moveto"
RMOVETO="rmoveto"
LINETO="lineto"
RLINETO="rlineto"
ARC="arc"
ARCN="arcn"
ARCTO="arcto"
CURVETO="curveto"
RCURVETO="rcurveto"
CLOSEPATH="closepath"
FLATTENPATH="flattenpath"
REVERSEPATH="reversepath"
STROKEPATH="strokepath"
CHARPATH="charpath"
CLIPPATH="clippath"
PATHBBOX="pathbbox"
PATHFORALL="pathforall"
INITCLIP="initclip"
CLIP="clip"
EOCLIP="eoclip"
ERASEPAGE="erasepage"
FILL="fill"
EOFILL="eofill"
STROKE="stroke"
IMAGE="image"
IMAGEMASK="imagemask"
SHOWPAGE="showpage"
COPYPAGE="copypage"
BANDDEVICE="banddevice"
FRAMEDEVICE="framdevice"
NULLDEVICE="nulldevice"
RENDERBANDS="renderbands"
DEFINEFONT="definefont"
FINDFONT="findfont"
SCALEFONT="scalefont"
MAKEFONT="makefont"
SETFONT="setfont"
CURRENTFONT="currentfont"
SHOW="show"
ASHOW="ashow"
WIDTHSHOW="widthshow"
AWIDTHSHOW="adwidthshow"
KSHOW="kshow"
STRINGWIDTH="stringwidth"
FONTDIRECTORY="fontdirectory"
STANDARDENCODING="standardencoding"
CACHESTATUS="cachestatus"
SETCACHEDEVICE="setcachedevice"
SETCHARWIDTH="setcharwidth"
SETCACHELIMIT="setcachelimit"
WHERE="where"
